0, 0, 0, 0, 0, 0, 0, 0, 0
0, 0, 0, 0, Route5, 0, 0, 0, 0
1, 1, 0, 1, 1, 1, 0, 1, 1
0, 1, 0, 1, 1, 1, 0, 1, 0
1, 1, 0, 1, 1, 1, 0, 1, 1
1, 1, 0, 1, 1, 1, 0, 1, 1
0, 1, 0, 1, 1, 1, 0, 1, 0
1, 1, 0, 1, 1, 1, 0, 1, 1
1, 1, 0, 1, 1, 1, 0, 1, 1
0, 1, 0, 1, SaffronCity, 1, 0, 1, 0
0, 0, 0, 0, 0, 0, 0, 0, 0
